11111111111
10000000001
10000E00001
1P000000C01
11111111111
